1111111111111111111111111111111111111111L
13222242211111112222322211111121222222231L
1211121222222222111111211111121222121121L
12111212121111122222242222222221211121121L
1222221212222211111111121212111212221121L
1211111111111222222222221212122212121121L
1022222221221121111111111212111112121121L
12121111212222322122222222222222221242221L
1212122121211121211111111211122111111211L
1212121121211121222222223222122111111211L
1212121221211121111121112112122111111211L
12121212112222222224222222122122111111211L
1212121211211111211101112121112222222211L
1112122222222112210000012122222111111111L
12222422121222112211111112111112222222231L
1211212121212222222222222222222211111121L
1211212111211111211111112121121111111121L
1211312222222222222222222222222222122121L
1211212111222212222122222122221222122121L
1222222212222101222212221222210122222221L
1111111212221000122212221222100012222111L
1222222212211111112221312221111111222121L
1211221112213222212222122221222221222121L
121122422222222222222222222224222222222121L
1211212222222222222222222222222222221121L
1211211211212221111121211112111212121221L
1211211221211111111121111211121212122311L
13222222212122242222222222222222312211111L
1111111111111111111111111111111111111111L