1111111111111111111111111111111111111111L
13222242211111112222322211111121222222231L
1211121222222222111111211111121222121121L
12111212121111122222242222222221211121121L
1222221212222211111111121212111212221121L
1211111111111222222222221212122212121121L
1022222221221121111111111212111112121121L
12121111212222322122222222222222221242221L
1212122121211121211111111211122111111211L
1212121121211121222222223222122111111211L
1212121221211121111121112112122111111211L